-------------------
-/YY\---------/YY\-
-\YY/---------\YY/-
-|YY|---------|YY|-
-\YYY\_______/YYY/-
--|YYYYYYYYYYYYY|--
--|YYY/     \YYY|--
--|YYY\_____/YYY|--
--\YYYYYYYYYYYYY/--
---\___________/---
-------------------
